,1,2,3,4,5,6,7,8,9,10,11,12,13,14,15,16,17,18,19,20
1,1,0,1,1,1,1,1,1,1,0,1,1,1,1,1,1,1,0,1,1
2,0,1,0,1,1,0,1,1,1,0,0,1,1,0,1,0,0,1,0,1
3,0,1,1,1,1,1,0,1,0,1,1,1,0,1,0,1,0,1,0,1
4,0,1,1,0,1,1,1,1,0,1,0,1,1,0,1,0,1,1,1,1
5,1,1,0,1,1,0,0,1,0,1,0,0,1,1,0,0,1,1,0,1
6,1,1,1,1,1,0,0,1,0,0,1,0,0,1,1,0,0,0,0,1
7,1,1,1,1,0,1,1,0,1,0,0,1,0,1,1,0,1,0,0,1
8,1,0,1,0,1,0,1,1,0,0,0,0,1,0,1,1,1,0,1,1
9,0,1,0,1,0,0,0,0,1,0,0,0,1,0,0,1,1,1,1,1
10,1,0,0,0,1,0,0,1,0,1,0,1,0,1,0,0,0,1,0,1
11,1,0,1,0,1,1,0,0,1,0,0,0,0,1,1,1,0,1,0,1
12,0,1,0,0,1,0,1,0,0,1,1,0,1,0,0,1,1,0,0,1
13,1,0,0,0,0,1,1,0,0,0,1,0,1,0,0,1,0,1,0,1
14,0,0,0,1,0,1,0,1,0,1,0,0,1,1,0,0,0,1,1,1
15,1,0,1,1,1,0,1,0,1,0,1,1,0,1,1,1,1,0,1,1
16,1,0,1,1,1,0,1,1,0,1,1,1,1,0,0,1,1,1,1,1
17,0,0,0,1,1,1,0,1,1,1,1,1,0,0,1,1,0,0,1,1
18,0,0,1,0,1,0,1,0,1,0,0,1,1,0,0,1,0,0,0,1
19,0,1,1,0,0,1,1,1,0,1,0,1,0,1,0,0,1,0,0,1
20,1,1,1,1,1,0,1,1,1,1,1,0,1,0,1,1,0,1,1,1